row = 0
0 0 0 0 0 
0 0 0 0 0 
0 0 0 0 0 
0 0 0 0 0 
0 0 0 0 0 

row = 1
0 0 0 0 0 
0 0 0 1 0 
0 1 1 1 0 
0 0 1 1 0 
0 0 0 0 0 

row = 2
0 0 0 0 0 
0 0 0 0 0 
0 1 1 1 0 
0 0 1 1 0 
0 0 0 1 0 

row = 3
0 0 0 0 0 
0 1 1 1 0 
0 0 0 1 0 
0 0 0 0 0 
0 0 0 0 0 

row = 4
0 0 0 0 0 
0 0 0 0 0 
0 0 0 0 0 
0 0 0 0 0 
0 0 0 0 0 

